[
    [
        "###############",
        "#OOOOOOOOOOOOO#",
        "#O1         2O#",
        "#O           O#",
        "#O           O#",
        "#O           O#",
        "#O OOOO OOOO O#",
        "#O           O#",
        "#O           O#",
        "#O           O#",
        "#O4         3O#",
        "#OOOOOOOOOOOOO#",
        "###############"
    ], [
        "###############",
        "#1   O O$   O2#",
        "# #O# #O# #O# #",
        "#    O O O   O#",
        "# #O# # # #O# #",
        "#O$    $ O O O#",
        "#O# #O# # #O# #",
        "#O  O   OO  $O#",
        "# #O#$# #O# # #",
        "#    O O   OO #",
        "#O#O# # # # # #",
        "#4 O    O  O 3#",
        "###############"
    ]
]